000000000000000000000000000000000000000000000000000000000000000WWWWWWWWWWWWWWWWWWW
000000000000000000000000000000000000000000000000000000000000000WWWWWWWWWWWWWWWWWWW
000000000000000000000000000000000000000000000000000000000000000WW000000WWW000000WW
000000000000000000000000000000000000000000000000000000000000000WW000000WWW000000WW
000000000000000000000000000000000000000000000000000000000000000WW0000W0WWW0W0000WW
000000000000000000000000000000000000000000000000000000000000000WW00000WWWWW00000WW
WWWWWWWWWWWWWWWWWWWWWWWWWWWWWWWWWWWWWWWWWWWWWWWWWWWWWWWWWWWWWWWWW000000WWW000000WWWWWWWWWWWWWWWWWWWWWWWWWWWWWWWWWWWWWWWWWWWWWWWWWWWWWWWWWWWWWWWWWWWWWWWWWWWWWWWWWW
WWWWWWWWWWWWWWWWWWWWWWWWWWWWWWWWWWWWWWWWWWWWWWWWWWWWWWWWWWWWWWWWW0000000W0000000WWWWWWWWWWWWWWWWWWWWWWWWWWWWWWWWWWWWWWWWWWWWWWWWWWWWWWWWWWWWWWWWWWWWWWWWWWWWWWWWWW
WW000000000000000000000000000000000000000000000000000000000000000000000000000000WW00000000000000WW00000000000000000000000000000000000000000000000000000000000000WW
WW000000000000000000000000000000000000000000000000000000000000000000000000000000WW00000000000000WW00000000000000000000000000000000000000000000000000000000000000WW
WW000000000000000000000000000000000000000000000000000000000000000000000000000000WW00000000000000WW00000000000000000000000000000000000000000000000000000000000000WW
WW000000000000000000000000000000000000000000000000000000000000000000000000000000WW00000000000000WW00000000000000000000000000000000000000000000000000000000000000WW
WW000000000000000000000000000000000000000000000000000000000000000000000000000000WW00000000000000WW00000000000000000000000000000000000000000000000000000000000000WW
WW000000000000000000000000000000000000000000000000000000000000000000000000000000WW00000000000000WW00000000000000000000000000000000000000000000000000000000000000WW
WW00000000000000000000000000000000000000000000000000000000000000S000000000000000WW00000000000000WW00000000000000000000000000000000000000000000000000000000000000WW
WW000000000000000000000000000000000000000000000000000000000000000000000000000000WW00000000000000WW00000000000000000000000000000000000000000000000000000000000000WW
WW000000000000000000000000000000000000000000000000000000000000000000000000000000WW00000000000000WW00000000000000000000000000000000000000000000000000000000000000WW
WW000000000000000000000000000000000000000000000000000000000000000000000000000000WW00000000000000WW00000000000000000000000000000000000000000000000000000000000000WW
WW000000000000000000000000000000000000000000000000000000000000000000000000000000WW00000000000000WW00000000000000000000000000000000000000000000000000000000000000WW
WW000000000000000000000000000000000000000000000000000000000000000000000000000000WW00000000000000WW00000000000000000000000000000000000000000000000000000000000000WW
WW000000000000000000000000000000000000000000000000000000000000000000000000000000WW00000000000000WW00000000000000000000000000000000000000000000000000000000000000WW
WW000000000000000000000000000000000000000000000000000000000000000000000000000000WW00000000000000WW00000000000000000000000000000000000000000000000000000000000000WW
WW00000000000000WWWWWWWWWWWWWWWWWWWWWWWWWWWWWWWWWWWWWWWWWWWWWWWWWWWWWWWWWWWWWWWWWW00000000000000WW00000000000000WWWWWWWWWWWWWWWWWWWWWWWWWWWWWWWWWW00000000000000WW
WW00000000000000WWWWWWWWWWWWWWWWWWWWWWWWWWWWWWWWWWWWWWWWWWWWWWWWWWWWWWWWWWWWWWWWWW00000000000000WW00000000000000WWWWWWWWWWWWWWWWWWWWWWWWWWWWWWWWWW00000000000000WW
WW00000000000000WW000000000000000000000000000000WW000000000000000000000000000000WW000000000000000000000000000000WW000000000000000000000000000000WW00000000000000WW
WW00000000000000WW000000000000000000000000000000WW000000000000000000000000000000WW000000000000000000000000000000WW000000000000000000000000000000WW00000000000000WW
WW00000000000000WW000000000000000000000000000000WW000000000000000000000000000000WW000000000000000000000000000000WW000000000000000000000000000000WW00000000000000WW
WW00000000000000WW000000000000000000000000000000WW000000000000000000000000000000WW000000000000000000000000000000WW000000000000000000000000000000WW00000000000000WW
WW00000000000000WW000000000000000000000000000000WW000000000000000000000000000000WW000000000000000000000000000000WW000000000000000000000000000000WW00000000000000WW
WW00000000000000WW000000000000000000000000000000WW000000000000000000000000000000WW000000000000000000000000000000WW000000000000000000000000000000WW00000000000000WW
WW00000000000000WW000000000000000000000000000000WW000000000000000000000000000000WW000000000000000000000000000000WW000000000000000000000000000000WW00000000000000WW
WW00000000000000WW000000000000000000000000000000WW000000000000000000000000000000WW000000000000000000000000000000WW000000000000000000000000000000WW00000000000000WW
WW00000000000000WW000000000000000000000000000000WW000000000000000000000000000000WW000000000000000000000000000000WW000000000000000000000000000000WW00000000000000WW
WW00000000000000WW000000000000000000000000000000WW000000000000000000000000000000WW000000000000000000000000000000WW000000000000000000000000000000WW00000000000000WW
WW00000000000000WW000000000000000000000000000000WW000000000000000000000000000000WW000000000000000000000000000000WW000000000000000000000000000000WW00000000000000WW
WW00000000000000WW000000000000000000000000000000WW000000000000000000000000000000WW000000000000000000000000000000WW000000000000000000000000000000WW00000000000000WW
WW00000000000000WW000000000000000000000000000000WW000000000000000000000000000000WW000000000000000000000000000000WW000000000000000000000000000000WW00000000000000WW
WW00000000000000WW000000000000000000000000000000WW000000000000000000000000000000WW000000000000000000000000000000WW000000000000000000000000000000WW00000000000000WW
WW00000000000000WW00000000000000WW00000000000000WW00000000000000WW00000000000000WW00000000000000WWWWWWWWWWWWWWWWWW00000000000000WW00000000000000WW00000000000000WW
WW00000000000000WW00000000000000WW00000000000000WW00000000000000WW00000000000000WW00000000000000WWWWWWWWWWWWWWWWWW00000000000000WW00000000000000WW00000000000000WW
WW000000000000000000000000000000WW00000000000000WW00000000000000WW00000000000000WW00000000000000WW000000000000000000000000000000WW00000000000000WW00000000000000WW
WW000000000000000000000000000000WW00000000000000WW00000000000000WW00000000000000WW00000000000000WW000000000000000000000000000000WW00000000000000WW00000000000000WW
WW000000000000000000000000000000WW00000000000000WW00000000000000WW00000000000000WW00000000000000WW000000000000000000000000000000WW00000000000000WW00000000000000WW
WW000000000000000000000000000000WW00000000000000WW00000000000000WW00000000000000WW00000000000000WW000000000000000000000000000000WW00000000000000WW00000000000000WW
WW000000000000000000000000000000WW00000000000000WW00000000000000WW00000000000000WW00000000000000WW000000000000000000000000000000WW00000000000000WW00000000000000WW
WW000000000000000000000000000000WW00000000000000WW00000000000000WW00000000000000WW00000000000000WW000000000000000000000000000000WW00000000000000WW00000000000000WW
WW000000000000000000000000000000WW00000000000000WW00000000000000WW00000000000000WW00000000000000WW000000000000000000000000000000WW00000000000000WW00000000000000WW
WW000000000000000000000000000000WW00000000000000WW00000000000000WW00000000000000WW00000000000000WW000000000000000000000000000000WW00000000000000WW00000000000000WW
WW000000000000000000000000000000WW00000000000000WW00000000000000WW00000000000000WW00000000000000WW000000000000000000000000000000WW00000000000000WW00000000000000WW
WW000000000000000000000000000000WW00000000000000WW00000000000000WW00000000000000WW00000000000000WW000000000000000000000000000000WW00000000000000WW00000000000000WW
WW000000000000000000000000000000WW00000000000000WW00000000000000WW00000000000000WW00000000000000WW000000000000000000000000000000WW00000000000000WW00000000000000WW
WW000000000000000000000000000000WW00000000000000WW00000000000000WW00000000000000WW00000000000000WW000000000000000000000000000000WW00000000000000WW00000000000000WW
WW000000000000000000000000000000WW00000000000000WW00000000000000WW00000000000000WW00000000000000WW000000000000000000000000000000WW00000000000000WW00000000000000WW
WW000000000000000000000000000000WW00000000000000WW00000000000000WW00000000000000WW00000000000000WW000000000000000000000000000000WW00000000000000WW00000000000000WW
WWWWWWWWWWWWWWWWWWWWWWWWWWWWWWWWWW00000000000000WW00000000000000WWWWWWWWWWWWWWWWWW00000000000000WW00000000000000WWWWWWWWWWWWWWWWWW00000000000000WW00000000000000WW
WWWWWWWWWWWWWWWWWWWWWWWWWWWWWWWWWW00000000000000WW00000000000000WWWWWWWWWWWWWWWWWW00000000000000WW00000000000000WWWWWWWWWWWWWWWWWW00000000000000WW00000000000000WW
WW000000000000000000000000000000WW00000000000000WW0000000000000000000000000000000000000000000000WW000000000000000000000000000000WW00000000000000WW00000000000000WW
WW000000000000000000000000000000WW00000000000000WW0000000000000000000000000000000000000000000000WW000000000000000000000000000000WW00000000000000WW00000000000000WW
WW000000000000000000000000000000WW00000000000000WW0000000000000000000000000000000000000000000000WW000000000000000000000000000000WW00000000000000WW00000000000000WW
WW000000000000000000000000000000WW00000000000000WW0000000000000000000000000000000000000000000000WW000000000000000000000000000000WW00000000000000WW00000000000000WW
WW000000000000000000000000000000WW00000000000000WW0000000000000000000000000000000000000000000000WW000000000000000000000000000000WW00000000000000WW00000000000000WW
WW000000000000000000000000000000WW00000000000000WW0000000000000000000000000000000000000000000000WW000000000000000000000000000000WW00000000000000WW00000000000000WW
WW000000000000000000000000000000WW00000000000000WW0000000000000000000000000000000000000000000000WW000000000000000000000000000000WW00000000000000WW00000000000000WW
WW000000000000000000000000000000WW00000000000000WW0000000000000000000000000000000000000000000000WW000000000000000000000000000000WW00000000000000WW00000000000000WW
WW000000000000000000000000000000WW00000000000000WW0000000000000000000000000000000000000000000000WW000000000000000000000000000000WW00000000000000WW00000000000000WW
WW000000000000000000000000000000WW00000000000000WW0000000000000000000000000000000000000000000000WW000000000000000000000000000000WW00000000000000WW00000000000000WW
WW000000000000000000000000000000WW00000000000000WW0000000000000000000000000000000000000000000000WW000000000000000000000000000000WW00000000000000WW00000000000000WW
WW000000000000000000000000000000WW00000000000000WW0000000000000000000000000000000000000000000000WW000000000000000000000000000000WW00000000000000WW00000000000000WW
WW000000000000000000000000000000WW00000000000000WW0000000000000000000000000000000000000000000000WW000000000000000000000000000000WW00000000000000WW00000000000000WW
WW000000000000000000000000000000WW00000000000000WW0000000000000000000000000000000000000000000000WW000000000000000000000000000000WW00000000000000WW00000000000000WW
WW00000000000000WW00000000000000WW00000000000000WW00000000000000WWWWWWWWWWWWWWWWWWWWWWWWWWWWWWWWWWWWWWWWWWWWWWWWWW00000000000000WW00000000000000WW00000000000000WW
WW00000000000000WW00000000000000WW00000000000000WW00000000000000WWWWWWWWWWWWWWWWWWWWWWWWWWWWWWWWWWWWWWWWWWWWWWWWWW00000000000000WW00000000000000WW00000000000000WW
WW00000000000000WW000000000000000000000000000000WW000000000000000000000000000000WW0000000000000000000000000000000000000000000000WW00000000000000WW00000000000000WW
WW00000000000000WW000000000000000000000000000000WW000000000000000000000000000000WW0000000000000000000000000000000000000000000000WW00000000000000WW00000000000000WW
WW00000000000000WW000000000000000000000000000000WW000000000000000000000000000000WW0000000000000000000000000000000000000000000000WW00000000000000WW00000000000000WW
WW00000000000000WW000000000000000000000000000000WW000000000000000000000000000000WW0000000000000000000000000000000000000000000000WW00000000000000WW00000000000000WW
WW00000000000000WW000000000000000000000000000000WW000000000000000000000000000000WW0000000000000000000000000000000000000000000000WW00000000000000WW00000000000000WW
WW00000000000000WW000000000000000000000000000000WW000000000000000000000000000000WW0000000000000000000000000000000000000000000000WW00000000000000WW00000000000000WW
WW00000000000000WW000000000000000000000000000000WW000000000000000000000000000000WW0000000000000000000000000000000000000000000000WW00000000000000WW00000000000000WW
WW00000000000000WW000000000000000000000000000000WW000000000000000000000000000000WW0000000000000000000000000000000000000000000000WW00000000000000WW00000000000000WW
WW00000000000000WW000000000000000000000000000000WW000000000000000000000000000000WW0000000000000000000000000000000000000000000000WW00000000000000WW00000000000000WW
WW00000000000000WW000000000000000000000000000000WW000000000000000000000000000000WW0000000000000000000000000000000000000000000000WW00000000000000WW00000000000000WW
WW00000000000000WW000000000000000000000000000000WW000000000000000000000000000000WW0000000000000000000000000000000000000000000000WW00000000000000WW00000000000000WW
WW00000000000000WW000000000000000000000000000000WW000000000000000000000000000000WW0000000000000000000000000000000000000000000000WW00000000000000WW00000000000000WW
WW00000000000000WW000000000000000000000000000000WW000000000000000000000000000000WW0000000000000000000000000000000000000000000000WW00000000000000WW00000000000000WW
WW00000000000000WW000000000000000000000000000000WW000000000000000000000000000000WW0000000000000000000000000000000000000000000000WW00000000000000WW00000000000000WW
WW00000000000000WWWWWWWWWWWWWWWWWWWWWWWWWWWWWWWWWWWWWWWWWWWWWWWWWW00000000000000WW00000000000000WWWWWWWWWWWWWWWWWWWWWWWWWWWWWWWWWW00000000000000WW00000000000000WW
WW00000000000000WWWWWWWWWWWWWWWWWWWWWWWWWWWWWWWWWWWWWWWWWWWWWWWWWW00000000000000WW00000000000000WWWWWWWWWWWWWWWWWWWWWWWWWWWWWWWWWW00000000000000WW00000000000000WW
WW00000000000000000000000000000000000000000000000000000000000000WW00000000000000WW0000000000000000000000000000000000000000000000WW000000000000000000000000000000WW
WW00000000000000000000000000000000000000000000000000000000000000WW00000000000000WW0000000000000000000000000000000000000000000000WW000000000000000000000000000000WW
WW00000000000000000000000000000000000000000000000000000000000000WW00000000000000WW0000000000000000000000000000000000000000000000WW000000000000000000000000000000WW
WW00000000000000000000000000000000000000000000000000000000000000WW00000000000000WW0000000000000000000000000000000000000000000000WW000000000000000000000000000000WW
WW00000000000000000000000000000000000000000000000000000000000000WW00000000000000WW0000000000000000000000000000000000000000000000WW000000000000000000000000000000WW
WW00000000000000000000000000000000000000000000000000000000000000WW00000000000000WW0000000000000000000000000000000000000000000000WW000000000000000000000000000000WW
WW00000000000000000000000000000000000000000000000000000000000000WW00000000000000WW0000000000000000000000000000000000000000000000WW000000000000000000000000000000WW
WW00000000000000000000000000000000000000000000000000000000000000WW00000000000000WW0000000000000000000000000000000000000000000000WW000000000000000000000000000000WW
WW00000000000000000000000000000000000000000000000000000000000000WW00000000000000WW0000000000000000000000000000000000000000000000WW000000000000000000000000000000WW
WW00000000000000000000000000000000000000000000000000000000000000WW00000000000000WW0000000000000000000000000000000000000000000000WW000000000000000000000000000000WW
WW00000000000000000000000000000000000000000000000000000000000000WW00000000000000WW0000000000000000000000000000000000000000000000WW000000000000000000000000000000WW
WW00000000000000000000000000000000000000000000000000000000000000WW00000000000000WW0000000000000000000000000000000000000000000000WW000000000000000000000000000000WW
WW00000000000000000000000000000000000000000000000000000000000000WW00000000000000WW0000000000000000000000000000000000000000000000WW000000000000000000000000000000WW
WW00000000000000000000000000000000000000000000000000000000000000WW00000000000000WW0000000000000000000000000000000000000000000000WW000000000000000000000000000000WW
WWWWWWWWWWWWWWWWWWWWWWWWWWWWWWWWWWWWWWWWWWWWWWWWWW00000000000000WWWWWWWWWWWWWWWWWWWWWWWWWWWWWWWWWWWWWWWWWWWWWWWWWW00000000000000WWWWWWWWWWWWWWWWWWWWWWWWWWWWWWWWWW
WWWWWWWWWWWWWWWWWWWWWWWWWWWWWWWWWWWWWWWWWWWWWWWWWW00000000000000WWWWWWWWWWWWWWWWWWWWWWWWWWWWWWWWWWWWWWWWWWWWWWWWWW00000000000000WWWWWWWWWWWWWWWWWWWWWWWWWWWWWWWWWW
WW0000000000000000000000000000000000000000000000WW00000000000000000000000000000000000000000000000000000000000000WW0000000000000000000000000000000000000000000000WW
WW0000000000000000000000000000000000000000000000WW00000000000000000000000000000000000000000000000000000000000000WW0000000000000000000000000000000000000000000000WW
WW0000000000000000000000000000000000000000000000WW00000000000000000000000000000000000000000000000000000000000000WW0000000000000000000000000000000000000000000000WW
WW0000000000000000000000000000000000000000000000WW00000000000000000000000000000000000000000000000000000000000000WW0000000000000000000000000000000000000000000000WW
WW0000000000000000000000000000000000000000000000WW00000000000000000000000000000000000000000000000000000000000000WW0000000000000000000000000000000000000000000000WW
WW0000000000000000000000000000000000000000000000WW00000000000000000000000000000000000000000000000000000000000000WW0000000000000000000000000000000000000000000000WW
WW0000000000000000000000000000000000000000000000WW00000000000000000000000000000000000000000000000000000000000000WW0000000000000000000000000000000000000000000000WW
WW0000000000000000000000000000000000000000000000WW00000000000000000000000000000000000000000000000000000000000000WW0000000000000000000000000000000000000000000000WW
WW0000000000000000000000000000000000000000000000WW00000000000000000000000000000000000000000000000000000000000000WW0000000000000000000000000000000000000000000000WW
WW0000000000000000000000000000000000000000000000WW00000000000000000000000000000000000000000000000000000000000000WW0000000000000000000000000000000000000000000000WW
WW0000000000000000000000000000000000000000000000WW00000000000000000000000000000000000000000000000000000000000000WW0000000000000000000000000000000000000000000000WW
WW0000000000000000000000000000000000000000000000WW00000000000000000000000000000000000000000000000000000000000000WW0000000000000000000000000000000000000000000000WW
WW0000000000000000000000000000000000000000000000WW00000000000000000000000000000000000000000000000000000000000000WW0000000000000000000000000000000000000000000000WW
WW0000000000000000000000000000000000000000000000WW00000000000000000000000000000000000000000000000000000000000000WW0000000000000000000000000000000000000000000000WW
WW00000000000000WWWWWWWWWWWWWWWWWWWWWWWWWWWWWWWWWWWWWWWWWWWWWWWWWWWWWWWWWWWWWWWWWWWWWWWWWWWWWWWWWW00000000000000WW00000000000000WWWWWWWWWWWWWWWWWW00000000000000WW
WW00000000000000WWWWWWWWWWWWWWWWWWWWWWWWWWWWWWWWWWWWWWWWWWWWWWWWWWWWWWWWWWWWWWWWWWWWWWWWWWWWWWWWWW00000000000000WW00000000000000WWWWWWWWWWWWWWWWWW00000000000000WW
WW00000000000000WW000000000000000000000000000000WW000000000000000000000000000000WW000000000000000000000000000000WW000000000000000000000000000000WW00000000000000WW
WW00000000000000WW000000000000000000000000000000WW000000000000000000000000000000WW000000000000000000000000000000WW000000000000000000000000000000WW00000000000000WW
WW00000000000000WW000000000000000000000000000000WW000000000000000000000000000000WW000000000000000000000000000000WW000000000000000000000000000000WW00000000000000WW
WW00000000000000WW000000000000000000000000000000WW000000000000000000000000000000WW000000000000000000000000000000WW000000000000000000000000000000WW00000000000000WW
WW00000000000000WW000000000000000000000000000000WW000000000000000000000000000000WW000000000000000000000000000000WW000000000000000000000000000000WW00000000000000WW
WW00000000000000WW000000000000000000000000000000WW000000000000000000000000000000WW000000000000000000000000000000WW000000000000000000000000000000WW00000000000000WW
WW00000000000000WW000000000000000000000000000000WW000000000000000000000000000000WW000000000000000000000000000000WW000000000000000000000000000000WW00000000000000WW
WW00000000000000WW000000000000000000000000000000WW000000000000000000000000000000WW000000000000000000000000000000WW000000000000000000000000000000WW00000000000000WW
WW00000000000000WW000000000000000000000000000000WW000000000000000000000000000000WW000000000000000000000000000000WW000000000000000000000000000000WW00000000000000WW
WW00000000000000WW000000000000000000000000000000WW000000000000000000000000000000WW000000000000000000000000000000WW000000000000000000000000000000WW00000000000000WW
WW00000000000000WW000000000000000000000000000000WW000000000000000000000000000000WW000000000000000000000000000000WW000000000000000000000000000000WW00000000000000WW
WW00000000000000WW000000000000000000000000000000WW000000000000000000000000000000WW000000000000000000000000000000WW000000000000000000000000000000WW00000000000000WW
WW00000000000000WW000000000000000000000000000000WW000000000000000000000000000000WW000000000000000000000000000000WW000000000000000000000000000000WW00000000000000WW
WW00000000000000WW000000000000000000000000000000WW000000000000000000000000000000WW000000000000000000000000000000WW000000000000000000000000000000WW00000000000000WW
WW00000000000000WW00000000000000WW00000000000000WW00000000000000WWWWWWWWWWWWWWWWWW00000000000000WWWWWWWWWWWWWWWWWWWWWWWWWWWWWWWWWW00000000000000WW00000000000000WW
WW00000000000000WW00000000000000WW00000000000000WW00000000000000WWWWWWWWWWWWWWWWWW00000000000000WWWWWWWWWWWWWWWWWWWWWWWWWWWWWWWWWW00000000000000WW00000000000000WW
WW00000000000000WW00000000000000WW00000000000000WW00000000000000WW0000000000000000000000000000000000000000000000WW000000000000000000000000000000WW00000000000000WW
WW00000000000000WW00000000000000WW00000000000000WW00000000000000WW0000000000000000000000000000000000000000000000WW000000000000000000000000000000WW00000000000000WW
WW00000000000000WW00000000000000WW00000000000000WW00000000000000WW0000000000000000000000000000000000000000000000WW000000000000000000000000000000WW00000000000000WW
WW00000000000000WW00000000000000WW00000000000000WW00000000000000WW0000000000000000000000000000000000000000000000WW000000000000000000000000000000WW00000000000000WW
WW00000000000000WW00000000000000WW00000000000000WW00000000000000WW0000000000000000000000000000000000000000000000WW000000000000000000000000000000WW00000000000000WW
WW00000000000000WW00000000000000WW00000000000000WW00000000000000WW0000000000000000000000000000000000000000000000WW000000000000000000000000000000WW00000000000000WW
WW00000000000000WW00000000000000WW00000000000000WW00000000000000WW0000000000000000000000000000000000000000000000WW000000000000000000000000000000WW00000000000000WW
WW00000000000000WW00000000000000WW00000000000000WW00000000000000WW0000000000000000000000000000000000000000000000WW000000000000000000000000000000WW00000000000000WW
WW00000000000000WW00000000000000WW00000000000000WW00000000000000WW0000000000000000000000000000000000000000000000WW000000000000000000000000000000WW00000000000000WW
WW00000000000000WW00000000000000WW00000000000000WW00000000000000WW0000000000000000000000000000000000000000000000WW000000000000000000000000000000WW00000000000000WW
WW00000000000000WW00000000000000WW00000000000000WW00000000000000WW0000000000000000000000000000000000000000000000WW000000000000000000000000000000WW00000000000000WW
WW00000000000000WW00000000000000WW00000000000000WW00000000000000WW0000000000000000000000000000000000000000000000WW000000000000000000000000000000WW00000000000000WW
WW00000000000000WW00000000000000WW00000000000000WW00000000000000WW0000000000000000000000000000000000000000000000WW000000000000000000000000000000WW00000000000000WW
WW00000000000000WW00000000000000WW00000000000000WW00000000000000WW0000000000000000000000000000000000000000000000WW000000000000000000000000000000WW00000000000000WW
WW00000000000000WW00000000000000WW00000000000000WW00000000000000WW00000000000000WWWWWWWWWWWWWWWWWW00000000000000WWWWWWWWWWWWWWWWWWWWWWWWWWWWWWWWWW00000000000000WW
WW00000000000000WW00000000000000WW00000000000000WW00000000000000WW00000000000000WWWWWWWWWWWWWWWWWW00000000000000WWWWWWWWWWWWWWWWWWWWWWWWWWWWWWWWWW00000000000000WW
WW000000000000000000000000000000WW00000000000000000000000000000000000000000000000000000000000000WW00000000000000000000000000000000000000000000000000000000000000WW
WW000000000000000000000000000000WW00000000000000000000000000000000000000000000000000000000000000WW00000000000000000000000000000000000000000000000000000000000000WW
WW000000000000000000000000000000WW00000000000000000000000000000000000000000000000000000000000000WW00000000000000000000000000000000000000000000000000000000000000WW
WW000000000000000000000000000000WW00000000000000000000000000000000000000000000000000000000000000WW00000000000000000000000000000000000000000000000000000000000000WW
WW000000000000000000000000000000WW00000000000000000000000000000000000000000000000000000000000000WW00000000000000000000000000000000000000000000000000000000000000WW
WW000000000000000000000000000000WW00000000000000000000000000000000000000000000000000000000000000WW00000000000000000000000000000000000000000000000000000000000000WW
WW000000000000000000000000000000WW00000000000000000000000000000000000000000000000000000000000000WW00000000000000000000000000000000000000000000000000000000000000WW
WW000000000000000000000000000000WW00000000000000000000000000000000000000000000000000000000000000WW00000000000000000000000000000000000000000000000000000000000000WW
WW000000000000000000000000000000WW00000000000000000000000000000000000000000000000000000000000000WW00000000000000000000000000000000000000000000000000000000000000WW
WW000000000000000000000000000000WW00000000000000000000000000000000000000000000000000000000000000WW00000000000000000000000000000000000000000000000000000000000000WW
WW000000000000000000000000000000WW00000000000000000000000000000000000000000000000000000000000000WW00000000000000000000000000000000000000000000000000000000000000WW
WW000000000000000000000000000000WW00000000000000000000000000000000000000000000000000000000000000WW00000000000000000000000000000000000000000000000000000000000000WW
WW000000000000000000000000000000WW00000000000000000000000000000000000000000000000000000000000000WW00000000000000000000000000000000000000000000000000000000000000WW
WW000000000000000000000000000000WW00000000000000000000000000000000000000000000000000000000000000WW00000000000000000000000000000000000000000000000000000000000000WW
WWWWWWWWWWWWWWWWWWWWWWWWWWWWWWWWWWWWWWWWWWWWWWWWWWWWWWWWWWWWWWWWWWWWWWWWWWWWWWWWWWEEEEEEEEEEEEEEWWWWWWWWWWWWWWWWWWWWWWWWWWWWWWWWWWWWWWWWWWWWWWWWWWWWWWWWWWWWWWWWWW
WWWWWWWWWWWWWWWWWWWWWWWWWWWWWWWWWWWWWWWWWWWWWWWWWWWWWWWWWWWWWWWWWWWWWWWWWWWWWWWWWWEEEEEEEEEEEEEEWWWWWWWWWWWWWWWWWWWWWWWWWWWWWWWWWWWWWWWWWWWWWWWWWWWWWWWWWWWWWWWWWW